{
    "tileset" : "chemin.png",
    "terrain" : [

        [2, 2, 2, 2, 2, 2, 2, 2, 2,  2,2, 2, 2, 2, 9, 10, 11, 2, 2,  2],
        [2, 2, 2, 2, 2, 2, 2, 2, 2,  2,2, 2, 2, 2, 9, 10, 11, 2, 2,  2],
        [2, 2, 2, 2, 2, 2, 2, 2, 2,  2,2, 2, 2, 2, 9, 10, 11, 2, 2,  2],
        [2, 2, 2, 2, 2, 2, 1, 1, 2,  2,2, 2, 2, 2, 9, 10, 11, 2, 2,  2],
        [2, 2, 2, 2, 2, 2, 2, 2, 2,  2,2, 2, 2, 2, 9, 10, 11, 2, 2,  2],
        [2, 2, 2, 2, 2, 2, 2, 1, 2,  2,2, 2, 2, 2, 9, 10, 11, 2, 2,  2],
        [2, 2, 2, 2, 2, 2, 2, 2, 2,  2,2, 2, 2, 2, 9, 10, 11, 2, 2,  2],
        [2, 2, 2, 2, 2, 2, 2, 2, 2,  1,2, 1, 2, 2, 9, 10, 11, 2, 2,  2],
        [2, 2, 2, 2, 2, 2, 2, 2, 2,  2,2, 2, 2, 2, 9, 10, 11, 2, 2,  2],
        [2, 2, 2, 2, 2, 2, 2, 2, 2,  2,2, 2, 2, 2, 9, 10, 11, 2, 2,  2],
        [2, 2, 2, 2, 2, 2, 2, 2, 2,  2,2, 2, 2, 2, 9, 10, 11, 2, 2,  2],
        [2, 2, 2, 2, 2, 2, 2, 2, 2,  2,2, 2, 2, 2, 9, 10, 11, 2, 2,  2],
        [2, 2, 2, 2, 2, 2, 2, 2, 2,  2,2, 2, 2, 2, 9, 10, 11, 2, 2,  2],
        [2, 2, 2, 2, 2, 2, 2, 2, 2,  2,2, 2, 2, 2, 9, 10, 11, 2, 2,  2],
        [2, 2, 2, 2, 2, 2, 2, 2, 2,  2,2, 2, 2, 2, 9, 10, 11, 2, 2,  2]
        ]
}